NO ./path_to_the_north_texture
SO ./path_to_the_south_texture
WE ./path_to_the_west_texture
EA ./path_to_the_east_texture
C 100,100,255
F 100,30,100


1111111111111
100000N0001 
1111111101111 
1111111 1

       1
      1011
11111  11